.......#..
#...#.....
##........
...#...#.#
.......#..
#.........
#.....###.
..##......
..##......
........##