........#.
##........
.........#
...##..#..
#...#..#..
#.........
#.......#.
#.........
.........#
##...###..